## Actual Geometry Maps

### Map at Y=0
``	ext
                                                         
                                                         
  #####################################################  
  ##..................##.............##........##....##  
  ##..................##.............##........##....##  
  ##..................##.............##........##....##  
  ##..................##.............##........##....##  
  ##..................#######...#########...#####....##  
  ##..................##.......................##....##  
  ##..................##.............................##  
  ##..................##.......................##....##  
  ##..................##.......................##....##  
  ######################.......................########  
  ##.................................................##  
  ##.................................................##  
  ##.................................................##  
  ##.................................................##  
  ##.................................................##  
  ##.................................................##  
  ##.................................................##  
  ##.................................................##  
  ##.................................................##  
  ##.................................................##  
  ##.................................................##  
  ##.................................................##  
  ##.................................................##  
  ##.................................................##  
  ##.................................................##  
  ##.................................................##  
  ##.................................................##  
  ##.................................................##  
  ##.................................................##  
  ##.................................................##  
  ##.................................................##  
  ##.................................................##  
  ##.................................................##  
  ##.................................................##  
  ##.................................................##  
  ##.................................................##  
  ##.................................................##  
  ##.................................................##  
  ##.................................................##  
  ##.................................................##  
  ##.................................................##  
  ##.................................................##  
  ##.................................................##  
  ##.................................................##  
  ##.................................................##  
  ##.................................................##  
  ##.................................................##  
  ##.................................................##  
  ##.................................................##  
  ##.................................................##  
  ##.................................................##  
  ##.................................................##  
  ##.................................................##  
  ##.................................................##  
  ##.................................................##  
  ##.................................................##  
  ##.................................................##  
  ##.................................................##  
  ##.................................................##  
  #####################################################  
                                                         
                                                         
``

### Map at Y=1
``	ext
                                                         
                                                         
  #####################################################  
  ##..................##.............##........##....##  
  ##..................##.............##........##....##  
  ##..................##.............##........##....##  
  ##..................##.............##........##....##  
  ##..................#######...#########...#####....##  
  ##..................##.......................##....##  
  ##..................##.............................##  
  ##..................##.......................##....##  
  ##..................##.......................##....##  
  ######################.......................########  
  ##.................................................##  
  ##.................................................##  
  ##.................................................##  
  ##.................................................##  
  ##.................................................##  
  ##.................................................##  
  ##.................................................##  
  ##.................................................##  
  ##.................................................##  
  ##.................................................##  
  ##.................................................##  
  ##.................................................##  
  ##.................................................##  
  ##.................................................##  
  ##.................................................##  
  ##.................................................##  
  ##.................................................##  
  ##.................................................##  
  ##.................................................##  
  ##.................................................##  
  ##.................................................##  
  ##.................................................##  
  ##.................................................##  
  ##.................................................##  
  ##.................................................##  
  ##.................................................##  
  ##.................................................##  
  ##.................................................##  
  ##.................................................##  
  ##.................................................##  
  ##.................................................##  
  ##.................................................##  
  ##.................................................##  
  ##.................................................##  
  ##.................................................##  
  ##.................................................##  
  ##.................................................##  
  ##.................................................##  
  ##.................................................##  
  ##.................................................##  
  ##.................................................##  
  ##.................................................##  
  ##.................................................##  
  ##.................................................##  
  ##.................................................##  
  ##.................................................##  
  ##.................................................##  
  ##.................................................##  
  ##.................................................##  
  #####################################################  
                                                         
                                                         
``

### Map at Y=4
``	ext
                                                         
                                                         
  #####################################################  
  ##..................##.............##........##....##  
  ##..................##.............##........##....##  
  ##..................##.............##........##....##  
  ##..................##.............##........##....##  
  ##..................###########################....##  
  ##..................##.......................##....##  
  ##..................##.......................##....##  
  ##..................##.......................##....##  
  ##..................##.......................##....##  
  ######################.......................########  
  ##.................................................##  
  ##.................................................##  
  ##.................................................##  
  ##.................................................##  
  ##.................................................##  
  ##.................................................##  
  ##.................................................##  
  ##.................................................##  
  ##.................................................##  
  ##.................................................##  
  ##.................................................##  
  ##.................................................##  
  ##.................................................##  
  ##.................................................##  
  ##.................................................##  
  ##.................................................##  
  ##.................................................##  
  ##.................................................##  
  ##.................................................##  
  ##.................................................##  
  ##.................................................##  
  ##.................................................##  
  ##.................................................##  
  ##.................................................##  
  ##.................................................##  
  ##.................................................##  
  ##.................................................##  
  ##.................................................##  
  ##.................................................##  
  ##.................................................##  
  ##.................................................##  
  ##.................................................##  
  ##.................................................##  
  ##.................................................##  
  ##.................................................##  
  ##.................................................##  
  ##.................................................##  
  ##.................................................##  
  ##.................................................##  
  ##.................................................##  
  ##.................................................##  
  ##.................................................##  
  ##.................................................##  
  ##.................................................##  
  ##.................................................##  
  ##.................................................##  
  ##.................................................##  
  ##.................................................##  
  ##.................................................##  
  #####################################################  
                                                         
                                                         
``


