## Actual Geometry Maps

### Map at Y=0
```text
                                                 
                                                 
  #...........................#........#......#  
  #...........................#........#......#  
  #...........................#........#......#  
  #...........................#........#......#  
  #...........................#........#......#  
  #...........................###....###......#  
  #...........................................#  
  #...........................................#  
  #...........................................#  
  #...........................................#  
  #.....................................#######  
  #...........................................#  
  #...........................................#  
  #...........................................#  
  #...........................................#  
  #...........................................#  
  #...........................................#  
  #...........................................#  
  #...........................................#  
  #...........................................#  
  #...........................................#  
  #...........................................#  
  #...........................................#  
  #...........................................#  
  #...........................................#  
  #...........................................#  
  #...........................................#  
  #...........................................#  
  #...........................................#  
  #...........................................#  
  #...........................................#  
  #...........................................#  
  #...........................................#  
  #...........................................#  
  #...........................................#  
  #...........................................#  
  #...........................................#  
  #...........................................#  
  #...........................................#  
  #...........................................#  
  #...........................................#  
  #...........................................#  
  #...........................................#  
  #...........................................#  
  #...........................................#  
  #...........................................#  
  #...........................................#  
  #...........................................#  
  #...........................................#  
  #...........................................#  
  #...........................................#  
  #...........................................#  
  #...........................................#  
  #...........................................#  
  #...........................................#  
  #...........................................#  
  #...........................................#  
  #...........................................#  
  #...........................................#  
  #...........................................#  
  #...........................................#  
                                                 
                                                 
```

### Map at Y=1
```text
                                                 
                                                 
  #...........................#........#......#  
  #...........................#........#......#  
  #...........................#........#......#  
  #...........................#........#......#  
  #...........................#........#......#  
  #...........................###....###......#  
  #...........................................#  
  #...........................................#  
  #...........................................#  
  #...........................................#  
  #.....................................#######  
  #...........................................#  
  #...........................................#  
  #...........................................#  
  #...........................................#  
  #...........................................#  
  #...........................................#  
  #...........................................#  
  #...........................................#  
  #...........................................#  
  #...........................................#  
  #...........................................#  
  #...........................................#  
  #...........................................#  
  #...........................................#  
  #...........................................#  
  #...........................................#  
  #...........................................#  
  #...........................................#  
  #...........................................#  
  #...........................................#  
  #...........................................#  
  #...........................................#  
  #...........................................#  
  #...........................................#  
  #...........................................#  
  #...........................................#  
  #...........................................#  
  #...........................................#  
  #...........................................#  
  #...........................................#  
  #...........................................#  
  #...........................................#  
  #...........................................#  
  #...........................................#  
  #...........................................#  
  #...........................................#  
  #...........................................#  
  #...........................................#  
  #...........................................#  
  #...........................................#  
  #...........................................#  
  #...........................................#  
  #...........................................#  
  #...........................................#  
  #...........................................#  
  #...........................................#  
  #...........................................#  
  #...........................................#  
  #...........................................#  
  #...........................................#  
                                                 
                                                 
```

### Map at Y=4
```text
                                                 
                                                 
  #...........................#........#......#  
  #...........................#........#......#  
  #...........................#........#......#  
  #...........................#........#......#  
  #...........................#........#......#  
  #...........................##########......#  
  #...........................................#  
  #...........................................#  
  #...........................................#  
  #...........................................#  
  #.....................................#######  
  #...........................................#  
  #...........................................#  
  #...........................................#  
  #...........................................#  
  #...........................................#  
  #...........................................#  
  #...........................................#  
  #...........................................#  
  #...........................................#  
  #...........................................#  
  #...........................................#  
  #...........................................#  
  #...........................................#  
  #...........................................#  
  #...........................................#  
  #...........................................#  
  #...........................................#  
  #...........................................#  
  #...........................................#  
  #...........................................#  
  #...........................................#  
  #...........................................#  
  #...........................................#  
  #...........................................#  
  #...........................................#  
  #...........................................#  
  #...........................................#  
  #...........................................#  
  #...........................................#  
  #...........................................#  
  #...........................................#  
  #...........................................#  
  #...........................................#  
  #...........................................#  
  #...........................................#  
  #...........................................#  
  #...........................................#  
  #...........................................#  
  #...........................................#  
  #...........................................#  
  #...........................................#  
  #...........................................#  
  #...........................................#  
  #...........................................#  
  #...........................................#  
  #...........................................#  
  #...........................................#  
  #...........................................#  
  #...........................................#  
  #...........................................#  
                                                 
                                                 
```


